生かす	いかす	生き返らせる	spare a person's life; bring ((a person)) back to life; revive ((a person)); make use of; utilize
行き成り	いきなり	何の前触れもなく急に事が起きるさま。突然。知らせなしに。	suddenly; all of a sudden; without (any) warning
意識	いしき	心が知覚を有しているときの状態。「ーを取り戻す」	consciousness;
何れ	いずれ	いろいろな過程を経たうえでの結果をいう。いずれにしても。結局。どのみち	anyhow; in any case;
何れにしても	いずれにしても	どちらを選ぶにしても。事情がどうであろうとも。どっちみち。いずれにせよ。	whichever
何れにせよ	いずれにせよ	経過がどうであろうと、結果は明らかだと認める気持ちを表す語。どうせ。結局は。	at any rate; anyhow
何時の間に	いつのまに	いつ。いつかわからないうちに。「ー仕上げたのだろう」	all too soon; without our noticing it; before (we) know it; not sure since when
何時までも	いつまでも	ある事柄が終わるときの限度がないさま。末長く。「―お幸せに」	forever; as long as you like
糸口1	いとぐち	巻いてある糸の端。糸の先。	the end of a thread
糸口2	いとぐち	きっかけ。手がかり。	a lead; a clue
隠蔽	いんぺい	人の所在、事の真相などを故意に覆い隠すこと。「証拠をーする」「ー工作」	hiding; concealment
胃	い		stomach
依	い		depending on
伊井	いい		that one, Italy
良い	いい		good
いい加減	いいかげん		moderate, right, random, not thorough, vague, irresponsible, halfhearted
言い方	いいかた	話のしかた。言葉づかい。言いよう。「持って回ったー」「もう少し何とかーがあったろうに」	expression; saying; way of speech
言い出す	いいだす		start talking, propose, suggest, break the ice
言い付ける	いいつける		tell, tell on (someone), to order, to charge, to direct
言い訳	いいわけ		excuse, explanation
委員	いいん		committee member
委員会	いいんかい	上位の合議体のために作業する、委員によって構成される組織体。また、その会議。	a committee ((on)); 〔特に政府任命の〕a commission on, a board; 〔会議〕a committee meeting
言う	いう		to say
家	いえ		house, family
家出	いえで		running away from home, leaving home
家主1	いえぬし		landlord
以下	いか		~ or less than?not more than
以外	いがい		except for, other than
意外	いがい		unexpected, surprising
如何	いかが		how, in what way
医学	いがく		medical science
雷1	いかずち		thunder
如何に	いかに		how?, in what way?, how much?, however, whatever
如何にも	いかにも		indeed, really, phrase meaning agreement
怒り	いかり		anger, hatred
怒る1	いかる		to get angry, to be angry
息	いき		breath, tone
行き	いき		going
粋	いき		chic, style, purity, essence
意義	いぎ		meaning, significance
異議	いぎ		objection, dissent, protest
生き生き	いきいき		vividly, lively
勢い	いきおい		force, vigor, energy, spirit, life, authority, influence, power, might, tendency, necessarily
域外	いきがい		outside the area
意気込む	いきごむ		to be enthusiastic about
経緯	いきさつ		details, whole story, sequence of events, particulars, how it started, how things got this way, complications, position
行き違い	いきちがい		misunderstanding, estrangement, disagreement, crossing without meeting, going astray
生き物	いきもの		animal
生きる	いきる		live, exist
行く	いく		to go
軍1	いくさ		war, battle, campaign, fight
戦	いくさ		war, battle, campaign, fight
育児	いくじ		childcare, nursing, upbringing
育成	いくせい		rearing, training, nurture, cultivation, promotion
幾多	いくた		many, numerous
幾つ	いくつ		how many?, how old?
幾分	いくぶん		somewhat
幾ら	いくら		how much?, how many?
池	いけ		pond
生け花	いけばな		flower arrangement
活ける	いける		to arrange (flowers)
異見	いけん		different opinion, objection
意見	いけん		opinion
以後	いご		from now on, thereafter
意向	いこう		intention, idea, inclination
移行	いこう		switching over to
以降	いこう		on and after, hereafter, thereafter
些か	いささか	数量・程度の少ないさま。ほんの少し。わずか。ついちょっと。「ーなりともお役に立ちたい」「この問題はー難しい」	a little; a bit; slightly
勇ましい	いさましい		brave, valiant, gallant, courageous
石	いし		stone
意志	いし		will, volition
意思	いし		intention, purpose
医師	いし		doctor
意地	いじ		disposition, spirit, willpower, obstinacy, backbone, appetite
維持	いじ		maintenance, preservation
碑	いしぶみ		stone monument bearing an inscription
苛める	いじめる		to tease, to torment, to persecute, to chastise
医者	いしゃ		doctor (medical)
移住	いじゅう		migration, immigration
衣装	いしょう		clothing, costume, outfit, garment, dress
以上	いじょう		more than, over
異常	いじょう		strangeness, abnormality, disorder
衣食住	いしょくじゅう		necessities of life (food, clothing, etc.)
弄る	いじる		to touch, to tamper with
意地悪	いじわる		malicious, ill-tempered, unkind
椅子	いす		chair
泉	いずみ		spring, fountain
異性	いせい		the opposite sex
遺跡	いせき		historic ruins (remains relics)
依然	いぜん		still, as yet
以前	いぜん		ago, since, before, previous
忙しい	いそがしい		busy, irritated
急ぐ	いそぐ		hurry (up)
依存	いそん		dependence, dependent, reliance
板	いた		board, plank
痛い	いたい		painful
偉大	いだい	すぐれて大きいさま。りっぱであるさま。「ーな業績」「ーな人物」	greatness
委託	いたく		consign (goods (for sale) to a firm), entrust (person with something), commit
抱く	いだく		embrace, hug, harbour, entertain, sleep with
致す	いたす		do
悪戯	いたずら		tease, prank, trick, practical joke, mischief
頂	いただき		(top of) head, summit, spire
頂く1	いただく	頭にのせる。かぶる。また、頭上にあるようにする。「王冠を―・く」「雪を―・いた山々」「星を―・いて夜道を行く」	〔上に載せる〕have (a hat) on; wear (a hat, a crown); be crowned (with)
頂く2	いただく	「食う」「飲む」の謙譲語。	take food or drink
頂く3	いただく	「もらう」の謙譲語。「激励の言葉を―・く」	receive (polite)
頂く4	いただく	（動詞の未然形に使役の助動詞「せる」「させる」の連用形、接続助詞「て」を添えた形に付いて）自己がある動作をするのを、他人に許してもらう意を表す。「させてもらう」の謙譲語。「あとで読ませて―・きます」「本日は休業させて―・きます」	receiving something for oneself;   (knitt this/explain this) for me
至って	いたって		very much, exceedingly, extremely
痛み	いたみ		pain, ache, sore, grief, distress
痛む	いたむ		to hurt, to feel a pain, to be injured
痛める	いためる		to hurt, to injure, to cause pain, to worry, to bother, to afflict, to be grieved over
至る	いたる		come, arrive
労る	いたわる		to pity, to sympathize with, to console, to care for, to be kind to
一	いち		one
市1	いち		market, fair
位地	いち		place, situation, position, location
位置	いち		location, position
一々	いちいち		one by one, separately
一応	いちおう		once, tentatively, in outline, for the time being
一概に	いちがいに		unconditionally, as a rule
一言1	いちげん		single word
一見	いちげん		unfamiliar, never before met
一時	いちじ		one hour, short time, once, temporarily, at one time
一日1	いちじつ		one day, first of month
一定1	いちじょう		fixed, settled, definite, uniform, regularized, defined, standardized, certain, prescribed
著しい	いちじるしい		remarkable, considerable
一段と	いちだんと		greater, more, further, still more
一度	いちど		once, one time
一同	いちどう		all present, all concerned, all of us
一度に	いちどに		all at once
一日2	いちにち		first of month
一人1	いちにん		one person
市場	いちば		town market, the marketplace (economics)
一番	いちばん		best, first, number one, a game, a round, a bout, a fall, an event (in a meet)
一部	いちぶ		one copy e.g. of a document, a part, partly, some
一部分	いちぶぶん		a part
一別	いちべつ		parting
一面	いちめん		one side, one phase, front page, the other hand, the whole surface
一目	いちもく		a glance, a look, a glimpse
一様	いちよう		uniformity, evenness, similarity, equality, impartiality
一律	いちりつ		evenness, uniformity, monotony, equality
一流	いちりゅう		foremost, top-notch, unique
一連	いちれん		a series, a chain, a ream (of paper)
何時	いつ		when, how soon
一家	いっか		house, home, a family, a household, one´s family, one´s folks, a style
五日	いつか		five days, the fifth day (of the month)
何時か	いつか		sometime, some day
一括	いっかつ		all together, batch, one lump, one bundle, summing up
一気	いっき		drink!(said repeatedly as a party cheer)
一挙に	いっきょに		at a stroke, with a single swoop
慈しみ	いつくしみ		affection
一切	いっさい		all, everything, without exception, the whole, entirely, absolutely
一昨日2	いっさくじつ		day before yesterday
一昨年2	いっさくねん		year before last
一種	いっしゅ		species, kind, variety
一瞬	いっしゅん		moment, instant
一緒	いっしょ		together, meeting, company
一生	いっしょう		lifetime, all through life, generation, age, era, the whole world
一生懸命	いっしょうけんめい		as well as one can, as hard as one can
一心	いっしん		one mind, wholeheartedness, the whole heart
一斉	いっせい		simultaneous
一層	いっそう		much more, still more, all the more
一帯	いったい		a region, a zone, the whole place
一体	いったい		one object, one body, generally, what on earth? really?
一旦	いったん		once, for a moment, one morning, temporarily
一致	いっち		coincidence, agreement, union, match, conformity, consistency, cooperation
五つ	いつつ		five
一定2	いってい		fixed, settled, definite, uniform, regularized, standardized, prescribed
何時でも	いつでも		(at) any time, always, at all times, never (neg), whenever
一敗	いっぱい		one defeat
一般	いっぱん		general, universal, ordinary, average, liberal
一変	いっぺん		complete change, about-face
一方	いっぽう		one side, one way, one direction, one party, the other party, on the other hand, meanwhile, only, simple, in turn
何時も	いつも		always, usually, every time, never (with neg. verb)
何時もながら	いつもながら	常と変わらないさま。いつものことではあるが。「ー元気だね」「ーの親切」	perennially; as always
いつもながら	何時もながら	常と変わらないさま。いつものことではあるが。「ー元気だね」「ーの親切」	perennially; as always
移転	いてん		moving, transfer, demise
意図	いと		intention, aim, design
糸	いと		thread
井戸	いど		water well
緯度	いど		latitude (geography)
移動	いどう		removal, migration, movement
異動	いどう		a change
従兄弟	いとこ		male cousin
従姉妹	いとこ		female cousin
営む	いとなむ		to carry on (e.g. in ceremony), to run a business
暇1	いとま		free time, leisure, leave, spare time, farewell
挑む	いどむ		to challenge, to contend for, to make love to
以内	いない		within
田舎	いなか		the country, country side
稲光	いなびかり		(flash of) lightning
古	いにしえ		antiquity, ancient times
犬	いぬ		dog
稲	いね		rice plant
居眠り	いねむり		dozing, nodding off
命	いのち		(mortal) life
祈り	いのり		prayer, supplication
祈る	いのる		pray
威張る	いばる		swagger, be proud
違反	いはん		violation (of law), transgression
衣服	いふく		clothes
居間	いま		living room (Western style)
今	いま		this, now
今更	いまさら		now, at this late hour
未だ1	いまだ		as yet, hitherto, not yet (neg)
今に	いまに		before long, even now
今にも	いまにも		at any time, soon
意味	いみ		meaning, significance
移民	いみん		emigration, immigration, emigrant, immigrant
妹	いもうと		younger sister
否	いや		no, nay, yes, well
嫌	いや		disagreeable, detestable, unpleasant, reluctant
嫌がる	いやがる		hate, dislike
卑しい	いやしい		greedy, vulgar, shabby, humble, base, mean, vile
意欲	いよく		will, desire, ambition
依頼	いらい		request, commission, dispatch, dependence, trust
以来	いらい		since, henceforth
いらっしゃる1		「行く」の尊敬語。おいでになる。「休日にはどこへ―・るのですか」	go; leave (for France)
いらっしゃる2		「来る」の尊敬語。おいでになる。「先生が―・った」	come by
いらっしゃる3		「居る」の尊敬語。おいでになる。「明日は家に―・いますか」	be; be in; be at home
入口1	いりくち		entrance, gate, approach, mouth
入口2	いりぐち		entrance, gate, approach, mouth
衣料	いりょう		clothing
医療	いりょう		medical care, medical treatment
威力	いりょく		power, might, authority, influence
入る1	いる		to get in, to go in, to come in, to flow into, to set, to set in
居る2	いる	人や動物が、ある場所に存在する。「ペンギンは北極にはーない」「そこにー・るのは誰ですか」	to be (animate), to exist
要る	いる		need
煎る	いる		to parch, to fry, to fire, to broil, to roast, to boil down (in oil)
衣類	いるい		clothes, clothing, garments
入れ物	いれもの		container, case, receptacle
入れる	いれる		put in, take in, bring in, let in, admit, introduce, usher in, insert, employ, listen to, tolerate, comprehend, include, pay (interest), cast (votes)
色	いろ		color, sensuality, lust
色々	いろいろ		various
異論	いろん		different opinion, objection
岩	いわ		rock, crag
祝い	いわい		celebration, festival
祝う	いわう		congratulate, celebrate
言わば	いわば		so to speak, so to call it, as it were
所謂	いわゆる		the so-called, so to speak
員	いん		member
印1	いん		seal, stamp, mark, print
印鑑	いんかん		stamp, seal
陰気	いんき		gloom, melancholy
隠居	いんきょ		retirement, retired person
印刷	いんさつ		printing
印象	いんしょう		impression
引退	いんたい	役職や地位から身を退くこと。スポーツなどで現役から退くこと。「ー興行」	retire
引用	いんよう		quotation, citation
引力	いんりょく		gravity
