故意	こい	わざとすること。また、その気持ち。「ーに取り違える」	intention
請う	こう	他人に、物を与えてくれるよう求める。訊く	ask; inquire
講じる	こうじる	手段を取る。「講ずる」の上一段化。	take (an action; the right step); try (a possibiliy)
肯定	こうてい	そうだと言うこと。認めりこと	affirmation; acknowledgement
凍り付く	こおりつく	硬く凍る	be frozen；freeze to
国産	こくさん		domestic manifacturing
告発	こくはつ	悪事や不正を明らかにして、世間に知らせること。告訴。訴え	a formal charge [accusation]((against))
越す	こす	来る	come over (here to e.g. the hospital)
骨頂	こっちょう	程度がこれ以上ないこと。	pinnacle
子供	こども		children; kids
この間1	このかん		during this time
殺す	ころす		kill
今後	こんご		future
児	こ		child, the young of animals
子	こ		child
故	こ		the late (deceased)
巨	こ		big, large, great
戸1	こ		counter for houses
恋	こい		love, tender passion
濃い	こい		thick (as of color, liquid), dense, strong
恋しい	こいしい		dear, beloved, darling,yearned for
恋する	こいする		to fall in love with, to love
恋人	こいびと		lover, sweetheart
校	こう		-school, proof
溝	こう		10^38, hundred undecillion (American), hundred sextillion (British)
好意	こうい		good will, favor, courtesy
行為	こうい		act, deed, conduct
行員	こういん		bank clerk
工員	こういん		factory worker
幸運	こううん		good luck, fortune
光栄	こうえい	業績や行動を褒められたり、重要な役目を任されたりして、名誉に思うこと。栄えること。「ーの至り」「身に過ぎてーなこと」	honor; privilage; glory
交易	こうえき		trade, commerce
公園	こうえん		(public) park
公演	こうえん		public performance
講演	こうえん		lecture, address
高価	こうか		high price
硬貨	こうか		coin
効果	こうか		effect, effectiveness, efficacy, result
航海	こうかい		sail, voyage
後悔	こうかい		regret, repentance
公開	こうかい		presenting to the public
郊外	こうがい		suburbs
公害	こうがい		public nuisance, pollution
工学	こうがく		engineering
交換	こうかん		exchange, interchange, reciprocity, barter, substitution
講義	こうぎ		lecture
抗議	こうぎ		protest, objection
高級	こうきゅう		high class, high grade
皇居	こうきょ		Imperial Palace
好況	こうきょう		prosperous conditions, healthy economy
公共	こうきょう		public, community, public service, society, communal
工業	こうぎょう		industry
鉱業	こうぎょう		mining industry
興業	こうぎょう		industrial enterprise
航空	こうくう		aviation, flying
光景	こうけい		scene, spectacle
工芸	こうげい		industrial arts
攻撃	こうげき		attack, strike, offensive, criticism, censure
貢献	こうけん	ある物事や社会のために役立つように尽力すること。貢ぎ物を奉ること。また、その品物。「学界の発展にーする」「ー度」	contribution, services
高原	こうげん		tableland, plateau
交互	こうご		mutual, reciprocal, alternate
高校	こうこう		high school
孝行	こうこう		filial piety
高校生	こうこうせい		high school student
考古学	こうこがく		archaeology
広告	こうこく		advertisement
交差	こうさ		cross
交際	こうさい		company, friendship, association, society, acquaintance
工作	こうさく		work, construction, handicraft, maneuvering
耕作	こうさく		cultivation, farming
交錯	こうさく	いくつかのものが入りまじること。「夢と現実がーする」	mix; intertwine
交差点	こうさてん		crossing, intersection
鉱山	こうざん		mine (ore)
講師	こうし		lecturer
工事	こうじ		construction work
公式	こうしき		formula, formality, official
口実	こうじつ		excuse
校舎	こうしゃ		school building
後者	こうしゃ		the latter
侯爵	こうしゃく	もと五等爵の第二位。伯爵の上。公爵の下。爵	marquis
講習	こうしゅう		short course, training
公衆	こうしゅう		the public
口述	こうじゅつ		verbal statement
控除	こうじょ		subsidy, deduction
高尚	こうしょう		high, noble, refined, advanced
交渉	こうしょう		negotiations, discussions, connection
向上	こうじょう		elevation, rise, improvement, advancement, progress
工場2	こうじょう		factory
行進	こうしん		march, parade
更新	こうしん		update
香辛料	こうしんりょう		spices
降水	こうすい		rainfall, precipitation
香水	こうすい		perfume
洪水	こうずい		flood
構成	こうせい		organization, composition
公正	こうせい		justice, fairness, impartiality
功績	こうせき		achievements, merit, meritorious service, meritorious deed
光線	こうせん		beam, light ray
公然	こうぜん		open (e.g. secret), public, official
高層	こうそう		upper
構想	こうそう		plan, plot, idea, conception
抗争	こうそう		dispute, resistance
構造	こうぞう		structure, construction
高速	こうそく		high speed, high gear
拘束	こうそく		restriction, restraint
交替	こうたい		alternation, change, shift, relief, relay
後退	こうたい		retreat, backspace (BS)
光沢	こうたく		brilliance, polish, lustre, glossy finish (of photographs)
公団	こうだん		public corporation
耕地	こうち		arable land
紅茶	こうちゃ		black tea
好調	こうちょう		favourable, promising, satisfactory, in good shape
校長	こうちょう		principal
交通	こうつう		traffic
交通機関	こうつうきかん		transportation facilities
校庭	こうてい		campus
高度	こうど		altitude, height, advanced
口頭	こうとう		oral
高等	こうとう		high class, high grade
講堂	こうどう		lecture hall
行動	こうどう		action, conduct, behaviour, mobilization
高等学校	こうとうがっこう		senior high school
購読	こうどく		subscription (e.g. magazine)
講読	こうどく		reading, translation
購入	こうにゅう		purchase, buy
公認	こうにん		official recognition, authorization, licence, accreditation
光熱費	こうねつひ		cost of fuel and light
工場1	こうば		factory, plant, mill, workshop
荒廃	こうはい		ruin
後輩	こうはい		junior (at work or school)
購買	こうばい		purchase, buy
交番	こうばん		police box
好評	こうひょう		popularity, favorable reputation
公表	こうひょう		official announcement, proclamation
交付	こうふ		delivering, furnishing (with copies)
降伏	こうふく		capitulation, surrender, submission
幸福	こうふく		happiness, blessedness
鉱物	こうぶつ		mineral
興奮	こうふん		excitement, stimulation, agitation, arousal
公平	こうへい		fairness, impartial, justice
候補	こうほ		candidacy
公募	こうぼ		public appeal, public contribution
巧妙	こうみょう		ingenious, skillful, clever, deft
公務	こうむ		official business, public business
公務員	こうむいん		public servant
項目	こうもく		item
紅葉1	こうよう		autumn colours
公用	こうよう		government business, public use, public expense
小売	こうり		retail
公立	こうりつ		public (institution)
効率	こうりつ		efficiency
交流	こうりゅう		alternating current, intercourse, (cultural) exchange, intermingling
考慮	こうりょ		consideration, taking into account
効力	こうりょく		effect, efficacy, validity, potency
声	こえ		voice
超える	こえる		to cross over, to cross, to pass through, to pass over (out of)
越える	こえる		to cross over, to cross, to pass through, to pass over (out of)
氷	こおり		ice
凍る	こおる		freeze, be frozen over, congeal
焦がす	こがす		burn, scorch, singe, char
小柄	こがら		short (build)
小切手	こぎって		cheque, check
呼吸	こきゅう		breath, respiration, knack, trick, secret (of doing something)
故郷	こきょう		home town, birthplace, old or historic village
漕ぐ	こぐ		to row, to scull, to pedal
国王	こくおう		king
国語	こくご		national language
国際	こくさい		international
国籍	こくせき		nationality
国定	こくてい		state-sponsored, national
国土	こくど		realm
告白	こくはく		confession, acknowledgement
黒板	こくばん		blackboard
克服	こくふく		subjugation, conquest
国防	こくぼう		national defence
国民	こくみん		people, citizen
穀物	こくもつ		grain, cereal, corn
国有	こくゆう		national ownership
国立	こくりつ		national
国連	こくれん		U.N., United Nations
焦げ茶	こげちゃ		black tea
焦げる	こげる		burn, be burned
個々	ここ		individual, one by one
箇箇	ここ		individual, separate
凍える	こごえる		freeze, be chilled, be frozen
心地	ここち		feeling, sensation, mood
九日	ここのか		nine days, the ninth day (of the month)
九つ	ここのつ		nine
凝らす	こごらす		to freeze, to congeal
凝る	こごる		to congeal, to freeze
心	こころ		mind, heart
心当たり	こころあたり		having some knowledge of, happening to know
心得	こころえ		knowledge, information
心得る	こころえる		be informed, have thorough knowledge
心掛け	こころがけ		readiness, intention, aim
心掛ける	こころがける		to bear in mind, to aim to do
志	こころざし		will, intention, motive
志す	こころざす		to plan, to intend, to aspire to, to set aims (sights on)
心強い	こころづよい		heartening, reassuring
心細い	こころぼそい		helpless, forlorn, hopeless, unpromising, lonely, discouraging, disheartening
試み	こころみ		trial, experiment<br />試みる(こころみる): to try, to test<br />試し(ためし): trial, test<br />試す(ためす): attempt, test<br />試合(しあい): game<br />試験(しけん): examination
快い	こころよい		pleasant, agreeable
腰	こし		hip
孤児	こじ		orphan
腰掛け	こしかけ		seat, bench
腰掛ける	こしかける		sit (down)
故障	こしょう		breakdown
故人	こじん		the deceased, old friend
個人	こじん		individual, personal, private
超す	こす		cross, pass, tide over
梢	こずえ		treetop
擦る2	こする		rub, scrub
個性	こせい		individuality, personality, idiosyncrasy
戸籍	こせき		census, family register
小銭	こぜに		coins, small change
固体	こたい		solid (body)
個体	こたい		an individual
古代	こだい		ancient times
答	こたえ		answer, response
答え	こたえ		answer (noun)
答える	こたえる		to answer, to reply
堪える1	こたえる		to bear, to stand, to endure, to put up with, to support, to withstand, to resist, to brave, to be fit for, to be equal to
火燵	こたつ		table with heater, (orig) charcoal brazier in a floor well
誇張	こちょう		exaggeration
骨1	こつ		knack, skill
国家	こっか		state, country, nation
国会	こっかい		National Diet, parliament, congress
小遣い	こづかい		personal expenses, pocket money, spending money, incidental expenses, allowance
国境2	こっきょう	隣接する国と国との境目。国家主権の及ぶ限界。河川・山脈などによる自然的なものと、協定などによって人為的に決定するものとがある。くにざかい。	national or state border
滑稽	こっけい		funny, humorous, comical, laughable, ridiculous, joking
国交	こっこう		diplomatic relations
骨折	こっせつ		bone fracture
小包	こづつみ		parcel, package
骨董品	こっとうひん		curio
固定	こてい		fixation
古典	こてん		old book, classic, classics
事	こと		thing, matter, fact, circumstances, business, reason, experience
琴	こと		koto (Japanese harp)
事柄	ことがら		matter, thing, affair, circumstance
孤独	こどく		isolation, loneliness, solitude
今年	ことし		this year
言付ける	ことづける		send word, send a message
言伝	ことづて		declaration, hearsay
異なる	ことなる		differ, vary, disagree
殊に	ことに		especially, above all
事によると	ことによると		depending on the circumstances
言葉	ことば	人が声に出して言ったり文字に書いて表したりする、意味のある表現。言うこと。「友人の―を信じる」	word(s), phrase, language, speech
言葉遣い	ことばづかい		speech, expression, wording
小鳥	ことり		(small) bird
断る	ことわる		refuse, reject, dismiss, turn down, decline, inform, give notice, ask leave, excuse oneself (from)
粉	こな		flour, meal, powder
粉々	こなごな		in very small pieces
この間2	このあいだ		the other day, lately, recently
この頃	このごろ		recently
好ましい	このましい		nice, likeable, desirable
好み	このみ		liking, taste, choice
好む	このむ		like, prefer
個別	こべつ		particular case
零す	こぼす		to spill
零れる	こぼれる		to overflow, to spill
細かい	こまかい		small, detailed
細やか	こまやか		friendly
困る	こまる		be troubled, be worried, be bothered
混む	こむ		to be crowded
込む	こむ		be crowded
小麦	こむぎ		wheat
米	こめ		rice
込める	こめる		to include, to put into
篭る	こもる		to seclude oneself, to be confined in, to be implied, to be stuffy
小屋	こや		hut, cabin, shed, (animal) pen
固有	こゆう		characteristic, tradition, peculiar, inherent, eigen-
小指	こゆび		little finger
雇用	こよう		employment (long term), hire
暦	こよみ		calendar, almanac
堪える2	こらえる		to bear, to stand, to endure, to put up with, to support, to withstand, to resist, to brave, to be fit for, to be equal to
孤立	こりつ		isolation, helplessness
懲りる	こりる		to learn by experience, to be disgusted with
頃2	ころ		time, about, toward, approximately (time)
転がす	ころがす		roll (transitive)
転がる	ころがる		roll, tumble
転ぶ	ころぶ		fall down, fall over
怖い	こわい		frightening
壊す	こわす		break, destroy
壊れる	こわれる		be broken
紺	こん		navy blue, deep blue
魂	こん		soul, spirit
今回	こんかい		now, this time, lately
根気	こんき		patience, perseverance, energy
根拠	こんきょ		basis, foundation
混血	こんけつ		mixed race, mixed parentage
今月	こんげつ		this month
混合	こんごう		mixing, mixture
混雑	こんざつ		confusion, congestion
今週	こんしゅう		this week
献立	こんだて		menu, program, schedule
昆虫	こんちゅう		insect, bug
根底	こんてい		root, basis, foundation
今度	こんど		next time
混同	こんどう		confusion, mixing, merger
困難	こんなん		difficulty, distress
今日1	こんにち		today
今日は	こんにちは		hello, good day (daytime greeting id)
今晩	こんばん		tonight, this evening
根本	こんぽん		origin, source, foundation, root, base, principle
今夜	こんや		tonight
婚約	こんやく		engagement, betrothal
混乱	こんらん		disorder, chaos, confusion, mayhem
