御2	お		honorific prefix
尾	お		tail, ridge
甥	おい	自分の兄弟・姉妹が生んだ男の子。	nephew
追い掛ける	おいかける		pursue, chase
追い越す	おいこす		to pass (e.g. car), outdistance
追い込む	おいこむ		to herd, to corner, to drive
美味しい	おいしい		delicious
追い焚き	おいだき		reheating
追い出す	おいだす		to expel, to drive out
追い付く	おいつく		overtake, catch up (with)
お出でになる	おいでになる		to be
老いる	おいる		to age, to grow old
お祝い	おいわい		celebration
負う	おう		to bear, to owe
王	おう		king
追う	おう		chase
応援	おうえん		aid, assistance, help, reinforcement, support, cheering
応急	おうきゅう		emergency
王国	おうこく		kingdom
黄金	おうごん		gold
王様	おうさま		king
王子	おうじ		prince
王女	おうじょ		princess
応じる1	おうじる	呼びかけに返事をする。応答する。	in answer to (your question); in response to (his call)
応じる2	おうじる	相手の働きかけに対応して行動を起こす。こたえる。従う	consent; agree (to conditions); accept (an order or challenge); meet/satisfy (a demand)
応じる3	おうじる	物事の変化に合わせて、それにふさわしく対応する。適合する。「その場に―・じた処置」	according to; in proportion to; depends on
欧州	おうしゅう		europe
黄色1	おうしょく		yellow
応ずる	おうずる		answer, respond, meet, satisfy, accept
応接	おうせつ		reception
応対	おうたい		receiving, dealing with
横断	おうだん		crossing
応答	おうとう		reply, comply (compatible)
往復	おうふく		round trip, coming and going, return ticket
欧米	おうべい		Europe and America, the West
応募	おうぼ		subscription, application
応用	おうよう		application, put to practical use
終える	おえる		to finish
多い	おおい		have a lot of
大いに	おおいに		very, much, greatly
覆う	おおう		cover, hide, conceal, wrap, disguise
大方	おおかた		perhaps, almost all, majority
大型	おおがた	物事の内容・規模、また、人物などが他のものより大きいこと。また、そのさま。「―の台風」「―の新人」「―バス」⇔小型。	large; large-sized
大柄	おおがら		large build, large pattern
大きい	おおきい		big, large, great
大きな	おおきな		big, large
大げさ	おおげさ		grandiose, exaggerated
大事1	おおごと		important, valuable, serious matter
大ざっぱ	おおざっぱ		rough (as in not precise), broad, sketchy
大筋	おおすじ		outline, summary
大勢	おおぜい		many, a great number (of people)
大空	おおぞら		heaven, firmament, the sky
大通り	おおどおり		main street
大幅	おおはば	普通より幅の広いこと。また、そのさま。⇔小幅。	full width, large scale, drastic
大水	おおみず		flood
大晦日	おおみそか	1年の最終の日。12月31日。おおつごもり。	the last day of the year; 〔その晩〕New Year's Eve
大家	おおや		landlord, landlady
公	おおやけ		official, public, formal, open, governmental
大凡	おおよそ		about, roughly, approximately, as a rule
丘	おか		hill
お母さん	おかあさん		(polite) mother
お蔭様で	おかげさまで		Thanks to god, thanks to you
お菓子	おかし		confections, sweets, candy
可笑しい	おかしい		strange, funny, amusing, ridiculous
侵す	おかす		to invade, to raid, to trespass, to violate, to intrude on
犯す	おかす		to commit, to perpetrate, to violate, to rape
お菜	おかず		side dish, accompaniment for rice dishes
お金	おかね		money
拝む	おがむ		worship, beg
お代わり	おかわり		second helping, another cup
沖	おき		open sea
置き換える	おきかえる	物をどかして他の物をそのあとに置く。「床の間の置物を生け花にー・える」「ここはもう少し的確な表現にー・えたい」	〔置く場所を変える〕change the location ((of))，change [shift, move]((a thing from A to B)); 〔配列し直す〕rearrange〔他の物と取り替える〕replace ((A with B)); substitute ((B for A))
置き去り	おきざり	あとに残したまま、行ってしまうこと。置き捨て。「子供をーにする」「絶海の孤島にーにされる」	leave; 〔見捨てる〕desert ((one's family))
お気遣いなく	おきづかいなく	気をつかわないように相手に丁寧に述べる表現。気遣い無用。	no worries!
補う	おぎなう		compensate for
起きる	おきる		get up, rise
置く	おく		put, place
奥	おく		interior
億	おく		a hundred million
屋外	おくがい		outdoors
奥さん	おくさん		(polite) wife, your wife, his wife, married lady, madam
屋上	おくじょう		the roof top
臆病	おくびょう		cowardice, timidity
遅らす	おくらす		to retard, to delay
送り仮名	おくりがな		kana written after a kanji to complete the full (usually kun) reading of the word
贈り物	おくりもの		gift
贈る	おくる		send, give to, award to, confer on
送る	おくる		send (a thing), take or escort (a person somewhere), see off (a person), spend a period of time, live a life
遅れ	おくれ		delay, lag
遅れる	おくれる		to be late
於ける	おける	作用・動作の行われる場所・時間を表す。…の中の。…での。…にあっての。「日本にー生活」「過去にー経験」	in (a field); within (a country)
起す	おこす		raise, cause, wake someone
起こす1	おこす	 横になっているものを立たせる。「からだを―・す」	〔横になったものを立てる〕raise
起こす2	おこす	 目を覚まさせる。「寝入りばなを―・される」	〔目を覚まさせる〕wake (up)
起こす3	おこす	今までなかったものを新たに生じさせる。「風力を利用して電気を―・す」「波を―・す」	〔始める〕start; begin
起こす4	おこす	平常と異なる状態や、好ましくない事態を生じさせる。ひきおこす。「革命を―・す」「事故を―・す」	〔引き起こす〕cause; bring about
起こす5	おこす		〔設立する〕establish; found
厳か	おごそか		austere, majestic, dignified, stately, awful, impressive
怠る	おこたる	すべきことをしないでおく。なまける。また、気をゆるめる。油断する。無視する。「学業を―・る」「注意を―・る」	neglect, be off guard, be feeling better
行い	おこない		deed, conduct, behavior, action, asceticism
行う	おこなう	物事をする。なす。やる。実施する。「儀式を―・う」「合同演習を―・う」「四月五日に入学式が―・われる」	to perform, to do, to conduct oneself, to carry out
起こる	おこる	今までなかったものが新たに生じる。おきる。「静電気が―・る」「さざ波が―・る」	occur, happen
怒る2	おこる		get angry
長	おさ		chief, head
押さえる	おさえる		to stop, to restrain, to seize, to repress, to suppress, to press down
押える	おさえる		stop, restrain, seize, repress, suppress, press down
抑える	おさえる	感情・欲望などが高ぶるのをとどめる。抑制する。スポーツで、相手の勢いをとどめる。	surpress; restrain; control
お先に	おさきに		before, ahead, previously
お酒	おさけ		(polite) wine, sake
幼い	おさない	年齢が若い。幼少である。いとけない。「息子はまだー・い」	very young, childish
治まる	おさまる		to be at peace, to clamp down, to lessen (storm terror anger)
納まる	おさまる		to be obtained, to end, to settle into, to fit into, to be settled, to be paid, to be delivered
収まる	おさまる		to be obtained, to end, to settle into, to fit into, to be settled, to be paid, to be delivered
治める	おさめる		govern, manage, subdue
納める	おさめる		to obtain, to reap, to pay, to supply, to accept
収める	おさめる		to obtain, to reap, to pay, to supply, to accept
お皿	おさら		(polite) dish, plate
お産	おさん		(giving) birth
叔父	おじ		uncle (younger than one´s parent)
惜しい	おしい		regrettable, disappointing, precious
お祖父さん	おじいさん		grandfather, male senior-citizen
押し入れ	おしいれ		closet
教え	おしえ		teachings, precept, lesson, doctrine
教える	おしえる		teach, inform, instruct
御辞儀	おじぎ		bow
押し込む	おしこむ		to push into, to crowd into
小父さん	おじさん		middle-aged gentleman, uncle
伯父さん	おじさん		middle-aged gentleman, uncle
惜しむ	おしむ		to be frugal, to value, to regret
お邪魔します	おじゃまします		Excuse me for disturbing (interrupting) you
お洒落	おしゃれ		smartly dressed, someone smartly dressed, fashion-conscious
お嬢さん	おじょうさん		daughter (polite)
押し寄せる	おしよせる		to push aside, to advance on
雄	おす		male (animal)
押す	おす		push, press, stamp (e.g. a passport)
お薦め	おすすめ		recommendation
お世辞	おせじ		flattery, compliment
汚染	おせん		pollution, contamination
遅い	おそい		late, slow
襲う	おそう		to attack
遅くとも	おそくとも		at the latest
恐らく	おそらく		perhaps
恐るべき	おそるべき	恐れなければならない。恐れるのが当然の。ひどく恐ろしい「ー自然破壊」	terrifying; terrible; dreadful
恐れ	おそれ		fear, horror
虞	おそれ	よくないことが起こるかもしれないという心配。懸念。「自殺の―がある」	〔懸念〕fear ((of))，apprehension ((about)); 〔危険〕danger
恐れ入る	おそれいる		to be filled with awe, to feel small, to be amazed, to be surprised, to be disconcerted, to be sorry, to be grateful, to be defeated, to confess guilt
恐れる	おそれる	危険を感じて不安になる。恐怖心を抱く。「報復をー・れる」「死をー・れる」	to fear, be afraid of
恐ろしい	おそろしい		terrible, dreadful
教わる	おそわる		be taught
お大事に	おだいじに		Take care of yourself
お互い	おたがい		mutual, reciprocal, each other
お宅	おたく		your house (polite)
汚濁	おだく		pollution, dirty, corruption. bribery
お玉	おたま		ladle
穏やか	おだやか		calm, gentle, quiet
落ち込む	おちこむ		to fall into, to feel down (sad)
落ち着き	おちつき		calm, composure
陥る	おちいる	望ましくない状態になる。よくない状態になる	fall into (critical position/predicament);
落着く	おちつく		calm down, settle in, be steady
落ち葉	おちば		fallen leaves, leaf litter, defoliation, shedding leaves
お茶	おちゃ		tea (green)
落ちる	おちる		fall, drop, come down
乙	おつ		strange, quaint, stylish, chic, spicy, queer, witty, tasty, romantic, 2nd in rank, second sign of the Chinese calendar
お使い	おつかい		errand
御疲れ様	おつかれさま	相手の労苦をねぎらう意で用いる言葉。また、職場で、先に帰る人へのあいさつにも使う。「ご苦労様」は目上の人から目下の人に使うのに対し、「お疲れ様」は同僚、目上の人に対して使う。	Cheers for good work
仰っしゃる	おっしゃる		to say, to speak, to tell, to talk
追っ手	おって	逃げていく者をつかまえるために追いかける人	pursuer
夫	おっと		(humble) (my) husband
お手上げ	おてあげ		all over, given in, given up hope, bring to knees
お手洗い	おてあらい		toilet, restroom, lavatory, bathroom (US)
お出掛け	おでかけ		about to start out, just about to leave or go out
お手伝いさん	おてつだいさん		maid
お手並み拝見	おてなみはいけん	相手の腕前や能力がどれくらいあるか拝見しよう。腕前を見せる	showing of skill
音3	おと		sound
弟1	おと		younger brother
お父さん	おとうさん		(polite) father
弟2	おとうと		younger brother, faithful service to those older, brotherly affection
弟神	おとうとがみ		younger god brother
脅かす	おどかす		to threaten, to coerce
男	おとこ		man
男の子	おとこのこ		boy
男の人	おとこのひと		man
落し物	おとしもの		lost property
落とす	おとす		drop, let fall
訪れる	おとずれる		to visit
脅す	おどす	相手を恐れさせる。脅迫する。おどかす。	threaten
一昨日1	おととい		day before yesterday
一昨年1	おととし		year before last
大人	おとな		adult
少女1	おとめ		daughter, young lady, virgin, maiden, little girl
お供	おとも		attendant, companion
踊り	おどり		dancing
踊り狂う	おどりくるう	夢中になって激しく踊る。「若者たちが―・う」	 dance like mad [like crazy／in a frenzy] (all night long)
劣る	おとる		fall behind, be inferior to
踊る	おどる		to dance
衰える	おとろえる		to become weak, to decline, to wear, to abate, to decay, to wither, to waste away
驚かす	おどろかす		surprise, frighten, create a stir
驚き	おどろき		surprise, astonishment, wonder
驚く	おどろく		to surprise
同い年	おないどし		of the same age
お腹	おなか		stomach
女子1	おなご		woman, girl
同じ	おなじ	同様。一緒	same
同じ穴のムジナ	おなじあなのもじな	普通、悪事を働く同類の意味で使われる	fellow rule-breaker (badger of the same hole)
鬼	おに		ogre, demon
お兄さん	おにいさん		(polite) older brother, (vocative) "Mister?"
お姉さん	おねえさん		(polite) older sister, (vocative) "Miss?"
お願いします	おねがいします		please
各々2	おのおの		each, every, either, respectively, severally
自ずから	おのずから		naturally, as a matter of course
己	おのれ		yourself
お祖母さん	おばあさん		grandmother, female senior-citizen
お化け	おばけ		ghost
伯母さん	おばさん		aunt
お早う	おはよう		Good morning
帯	おび		kimono sash
お昼	おひる		lunch, noon
帯びる	おびる		to wear, to carry, to be entrusted, to have, to take on, to have a trace of, to be tinged with
お弁当	おべんとう		lunch box
覚え	おぼえ		memory, sense, experience
覚える1	おぼえる	見聞きした事柄を心にとどめる。記憶する。「子供のころのことはー・えていない」	learn, remember, bear ((a thing)) in mind; memorize
覚える2	おぼえる	からだや心に感じる。「疲れをー・える」「愛着をー・える」	feel
憶える	おぼえる	見聞きした事柄を心にとどめる。記憶する。「子供のころのことはー・えていない」	learn, remember, bear ((a thing)) in mind; memorize
溺れる	おぼれる		be drowned, indulge in
お参り	おまいり		worship, shrine visit
御負け	おまけ		a discount, a prize, something additional, bonus, an extra, an exaggeration
お祭り	おまつり		festival
お巡りさん	おまわりさん		policeman (friendly term)
お見舞い	おみまい		asking after (a person´s health)
お宮	おみや		Shinto shrine
お土産	おみやげ		souvenir
汚名	おめい		stigma; dishonour; dishonor; infamy
お目出度う	おめでとう		(ateji) (int) (uk) Congratulations!, an auspicious occasion!
お目に掛かる	おめにかかる		to see or meet someone
面1	おも		face
重い	おもい		heavy, massive, serious, important, severe, oppressed
思い掛けない	おもいがけない		unexpected, casual
思い込む	おもいこむ		be under impression that, be convinced that, imagine that, set one´s heart on, be bent on
思い切り	おもいきり	あきらめ。満足できるまでするさま。思う存分。「―遊びたい」「―がいい」	〔思う存分〕to one's heart's content; 〔力一杯〕to the best of one's ability; with all one's might
思い出す	おもいだす		recall, remember
思い付き	おもいつき		plan, idea, suggestion
思い付く	おもいつく		think of, hit upon, come into one´s mind
思い出	おもいで		memories, recollections, reminiscence
思う	おもう		think
思う存分	おもうぞんぶん	満足がいくまで。思いきり。「―（に）遊びたい」「―の働き」	all (I) want; as hard as one (can); (eat) to one's fill; (cry one) heart out
面白い	おもしろい		interesting, amusing
重たい	おもたい		heavy, massive, serious, important, severe, oppressed
表2	おもて		the front
重なる1	おもなる		main, principal, important
主に	おもに		mainly, primarily
趣	おもむき		meaning, tenor, gist, effect, appearance, taste, grace, charm, refinement
赴く	おもむく		to go, to proceed, to repair to, to become
重役1	おもやく		heavy responsibilities, director
思わず	おもわず	そのつもりではないのに。考えもなく。無意識に。気が付かずに。本能的に	unintentionally; spontanuously
重んじる	おもんじる		to respect, to honor, to esteem, to prize
重んずる	おもんずる		to honor, to respect, to esteem, to prize
親	おや		parents
お休み	おやすみ		holiday, absence, rest, Good night
親父	おやじ		father
お八	おやつ		(uk) between meal snack, afternoon refreshment, afternoon tea, mid-day snack
親指	おやゆび		thumb
泳ぎ	およぎ		swimming
泳ぐ	およぐ		swim
凡そ	およそ		about, roughly, as a rule, approximately
及び	および		and, as well as
及ぶ	およぶ		to reach, to come up to, to amount to, to befall, to happen to, to extend, to match, to equal
及ぼす	およぼす		exert, cause, exercise
織	おり		weave, weaving, woven item
折り合い	おりあい	譲り合って解決すること。妥協・折衷「大筋でのーがつく」	compromise
折り返す	おりかえす		to turn up, to fold back
折紙	おりがみ	紙を折って種々の物の形を作る遊び。また、それに使う紙。ふつう、正方形の色紙 (いろがみ) を使う。	origami
織物	おりもの		textile, fabric
下りる	おりる		come down
降りる8	おりる	霧や霜などが地上・空中などに生じる。「露がー・りる」	(e.g. frost;dew) to fall
居る1	おる	人が存在する。そこにいる。「海外に何年―・られましたか」	be here (polite)
居る3	おる	（「おります」の形で、自分や自分の側の者についていう）「いる」の丁寧な言い方。「五時までは会社に―・ります」	be here (polite)
折る	おる		break, fold, pick (flower)
織る	おる		to weave
俺	おれ		I (ego) (boastful first-person pronoun)
お礼	おれい		courtesy
折れる	おれる		break, snap
愚か	おろか	頭の働きが鈍いさま。考えが足りないさま。	foolish; silly; stupid
愚かしい	おろかしい		foolish, stupid
卸売り	おろしうり	生産者や輸入業者から大量の商品を仕入れ、小売商に売り渡すこと。また、その業種や業者。	wholesale
下す	おろす		take down, launch, drop, lower, let (a person) off, unload, discharge
降ろす	おろす		to take down, to launch, to drop, to lower, to let (a person) off, to unload, to discharge
卸す	おろす		sell wholesale, grated (vegetables)
疎か	おろそか		neglect, negligence, carelessness
終わり	おわり		the end
終わる	おわる	続いていた物事が、そこでなくなる。しまいになる。済む。「授業が―・る」「一生が―・る」⇔始まる。	〔おしまいになる〕end, be over, finish, be finished; 〔おしまいにする〕finish, end
終る	おわる		finish, close
音2	おん		sound, (music) note
恩	おん		favour, obligation, debt of gratitude
音色	おんいろ		tone color, tone quality, timbre, synthesizer patch
音楽	おんがく		music
恩恵	おんけい		grace, favor, blessing, benefit
温室	おんしつ		greenhouse
恩赦	おんしゃ		pardon, amnesty
暗礁	あんしょう		reef, sunken rock
音声	おんせい	テレビなどの音	sound; a voice; speech
温泉	おんせん		spa, hot spring
温帯	おんたい		temperate zone
温暖	おんだん		warmth
御中	おんちゅう		and Company, Messrs.
温度	おんど		temperature
女	おんな		woman, girl, daughter
女癖	おんなぐせ	男がすぐ、女性関係を持つこと。多く「ーが悪い」の形で用いる。	philanderer; womanizer
女の子	おんなのこ		girl
女の人	おんなのひと		woman
温和	おんわ		gentle, mild, moderate
