最多	さいた	一番大きい	most
最中	さいちゅう	進行中のとき	midst; in the middle of
採用	さいよう	適当であると思われる人物・意見・方法などを、とり上げて用いること。	adoption; employment
些細	ささい	あまり重要ではないさま。取るに足らないさま。「ーなことを気にする」	〜な trifling; trivial
参加	さんか	ある目的をもつ集まりに一員として加わり、行動をともにすること。	participation
差	さ		difference, variation
佐	さ		help
歳	さい		-years-old
差異	さい		difference, disparity
際2	さい		edge, brink, verge, side
再	さい		re-, again, repeated
再会	さいかい		another meeting, meeting again, reunion
災害	さいがい		calamity, disaster, misfortune
再稼動	さいかどう		a restart; restarting
最近	さいきん		recently
細菌	さいきん		bacillus, bacterium, germ
細工	さいく		work, craftsmanship, tactics, trick
採掘	さいくつ		mining
採決	さいけつ		vote, roll call
再建	さいけん		rebuilding, reconstruction, rehabilitation
再現	さいげん		reappearance, reproduction, return, revival
最後	さいご		last time
最高	さいこう		highest, supreme, the most
再三	さいさん		again and again, repeatedly
採算	さいさん		profit
祭司	さいし	1.祭儀を執り行う者。2.ユダヤ教で、神殿に奉仕して儀式をつかさどる者。	a [an officiating] priest
祭日	さいじつ		national holiday, festival day
採集	さいしゅう		collecting, gathering
最終	さいしゅう		last, final, closing
最初	さいしょ		first time
再生	さいせい		playback, regeneration, resuscitation, return to life, rebirth, reincarnation, narrow escape, reclamation, regrowth
最善	さいぜん		the very best
催促	さいそく		request, demand, claim, urge (action), press for
採択	さいたく		adoption, selection, choice
最低	さいてい		least, lowest, worst, nasty, disgusting, horrible, yuck!
最適	さいてき	いちばん適していること。また、そのさま。「会計には彼が―だ」「スキーに―な雪質」	optimum (most suitible)
最適化	さいてきか	《optimization》システム工学などで、特定の目的に最適の計画・システムを設計すること。コンピューターでは、プログラムを特定の目的に最も効率的なように書き換えること。オプティマイズ。オプティマイゼーション。	optimization
採点	さいてん		marking, grading, looking over
災難	さいなん		calamity, misfortune
才能	さいのう		talent, ability
栽培	さいばい		cultivation
再発	さいはつ		return, relapse, reoccurrence
裁判	さいばん		trial, judgement
財布	さいふ		purse, wallet
裁縫	さいほう		sewing
細胞	さいぼう		cell (biology)
幸い	さいわい		happiness, blessedness
遮る	さえぎる		to interrupt, to intercept, to obstruct
坂	さか		slope, hill
境	さかい		border, boundary, mental state
栄える	さかえる		to prosper, to flourish
差額	さがく		balance, difference, margin
逆さ	さかさ		reverse, inversion, upside down
逆様	さかさま		inversion, upside down
捜す	さがす		search, seek, look for
探す	さがす		search for, look for
杯	さかずき		wine cups
逆立ち	さかだち		handstand, headstand
魚2	さかな		fish
逆上る	さかのぼる		to go back, to go upstream, to make retroactive
遡る	さかのぼる		go back, go upstream, make retroactive
酒場	さかば		bar, bar-room
逆らう	さからう		go against, oppose, disobey, defy
盛り	さかり		summit, peak, prime
盛る1	さかる		to prosper, to flourish, to copulate (animals)
下る2	さがる		hang down, abate, retire, fall, step back
下がる	さがる		down
盛ん	さかん		prosperous
先	さき		the future, forward, priority, precedence, former, previous, old, late
詐欺	さぎ		fraud, swindle
一昨昨日	さきおととい		two days before yesterday
先に	さきに		before, earlier than, ahead, beyond, away, previously, recently
先程	さきほど		some time ago
作業	さぎょう		work, operation, manufacturing, fatigue duty
裂く	さく		to tear, split
策	さく		plan, policy
昨	さく		last (year), yesterday
作	さく		a work, a harvest
咲く	さく		to bloom
柵	さく		fence, paling
索引	さくいん		index, indices
削減	さくげん		cut, reduction, curtailment
錯誤	さくご		mistake
作者	さくしゃ		author
削除	さくじょ		elimination, cancellation, deletion, erasure
作成	さくせい		frame, draw up, make, producing, creating, preparing, writing,
作製	さくせい		manufacture
作戦	さくせん		military or naval operations, tactics, strategy
昨晩	さくばん	きのうの晩。ゆうべ。昨夜。	last night; yesterday evening
作品	さくひん		work, opus, performance, production
作物1	さくぶつ		literary work
作文	さくぶん		composition, writing
作物2	さくもつ		literary work
桜	さくら		cherry blossom, cherry tree
探る	さぐる		search, look for, sound out
酒	さけ		alcohol, sake
叫び	さけび		shout, scream, outcry
叫ぶ	さけぶ		shout, cry out
裂ける	さける		to split, to tear, to burst
避ける	さける		avoid (situation), ward off, to avert
下げる	さげる		hang, let down
支える	ささえる		support, prop up
刺さる	ささる		stick, be stuck
些事	さじ		something small or petty, trifle
差し上げる	さしあげる		give
差し掛かる	さしかかる		to come near to, to approach
指図	さしず		instruction, mandate
差し出す	さしだす		to present, to submit, to tender, to hold out
差し支え	さしつかえ		hindrance, impediment
差し支える	さしつかえる		to interfere, to hinder, to become impeded
差し引き	さしひき		deduction, subtraction, balance, ebb and flow, rise and fall
差し引く	さしひく		to deduct
刺身	さしみ		sliced raw fish
注す	さす		pour or serve (drinks)
刺す	さす		pierce, stab, prick, thrust, bite, sting, pin down
差す	さす		raise (stretch out) hands, to raise umbrella
指す	さす		to point, put up umbrella, to play
挿す	さす		to insert, put in, graft
射す	さす		to shine, to strike
流石	さすが		clever, adept, good, expectations, as one would expect
授ける	さずける		to grant, to award, to teach
誘う	さそう		invite, call out
定まる	さだまる		to become settled, to be fixed
定める	さだめる		to decide, to establish, to determine
札	さつ		paper money
冊	さつ		counter for books
撮影	さつえい		photographing
作家	さっか		author, writer, novelist, artist
錯覚	さっかく		optical illusion, hallucination
早急	さっきゅう		urgent
作曲	さっきょく		composition, setting (of music)
殺人	さつじん		murder
察する	さっする		to guess, to sense, to presume, to judge, to sympathize with
早速	さっそく		at once, immediately, without delay, promptly
砂糖	さとう		sugar
悟る	さとる		to attain enlightenment, to perceive, to understand, to discern
真実	さな		truth, reality
砂漠	さばく		desert
裁く	さばく		to judge
寂しい	さびしい		lonely
差別	さべつ		discrimination, distinction, differentiation
作法	さほう		manners, etiquette, propriety
左程	さほど		(not) very, (not) much
様1	さま		Mr. or Mrs., manner, kind, appearance
様々	さまざま		varied, various
覚ます	さます		awaken, disabuse, sober up
冷ます	さます		cool, dampen, let cool, throw a damper on, spoil
妨げる	さまたげる		disturb, prevent
三味線	さみせん		three-stringed Japanese guitar, shamisen
寒い	さむい		cold (e.g. weather)
侍	さむらい		Samurai, warrior
覚める	さめる		wake, wake up
冷める	さめる		become cool, wear off, abate, subside, dampen
然も	さも		with gusto, with satisfaction
左右	さゆう		left and right, influence, control, domination
作用	さよう		action, operation, effect, function
左様なら	さようなら		good-bye
皿	さら		plate, dish
再来月	さらいげつ		month after next
さ来月	さらいげつ		the month after next
再来週	さらいしゅう		week after next
さ来週	さらいしゅう		the week after next
再来年	さらいねん		year after next
拐う	さらう		to carry off, to run away with, to kidnap, to abduct
更に	さらに		furthermore, again, after all, more and more, moreover
猿	さる		monkey
去る	さる		leave, go away
騒がしい	さわがしい		noisy
騒ぎ	さわぎ		uproar, disturbance
騒ぐ	さわぐ		make a noise
爽やか	さわやか		fresh, refreshing, invigorating, clear, fluent, eloquent
障る	さわる		to hinder, to interfere with, to affect, to do one harm, to be harmful to
触る	さわる		touch
三2	さん		three
酸	さん		acid
酸化	さんか		oxidation
三角	さんかく		triangle, triangular
山岳	さんがく		mountains
参議院	さんぎいん		House of Councillors
産休	さんきゅう		maternity leave
桟橋	さんきょう		wharf, bridge, jetty, pier
産業	さんぎょう		industry
産後	さんご		postpartum, after childbirth
参考	さんこう		reference, consultation
産出	さんしゅつ		yield, produce
参照	さんしょう		reference, consultation, consultation
参上	さんじょう		calling on, visiting
算数	さんすう		arithmetic
賛成	さんせい		approval, agreement, support, favour
酸性	さんせい		acidity
酸素	さんそ		oxygen
産地	さんち		producing area
賛美	さんび		praise, adoration, glorification
山腹	さんぷく		hillside, mountainside
産婦人科	さんふじんか		maternity and gynecology department
産物	さんぶつ		product, result, fruit
散歩	さんぽ		walk, stroll
山脈	さんみゃく		mountain range
山林	さんりん		mountain forest, mountains and forest
