添う	そう		to accompany, to become married, to comply with
沿う	そう		to run along, to follow
僧	そう		monk, priest
総	そう		whole, all, general, gross
相違	そうい		difference, discrepancy, variation
相応	そうおう		suitability, fitness
騒音	そうおん		noise
総会	そうかい		general meeting
総括	そうかつ	概要	generalization, summary
創刊	そうかん		launching (e.g. newspaper), first issue
葬儀	そうぎ	死者をほうむる儀式。葬式	Funeral
送金	そうきん		remittance, sending money
総計	そうけい	全体をひっくるめて計算すること。また、その合計。「一か月の支出を―する」→小計	the total [sum]
倉庫	そうこ		storehouse, warehouse
相互	そうご		mutual, reciprocal
走行	そうこう		running a wheeled vehicle (e.g. car), traveling
総合	そうごう		synthesis, coordination, putting together, integration, composite
操作	そうさ		operation, management, processing
捜査	そうさ		search (esp. in criminal investigations), investigation
総裁	そうさい	政党・銀行・公社などの長として、全体を取りまとめる職務。また、その人。「―選挙」「日銀―」	president (総裁候補)
捜査官	そうさかん		(police) investigator
捜索	そうさく		search (esp. for someone or something missing), investigation
創作	そうさく		production, literary creation, work
掃除	そうじ		cleaning, sweeping
葬式	そうしき		funeral
操縦	そうじゅう		management, handling, control, manipulation
操縦士	そうじゅうし		pilot
装飾	そうしょく		ornament
送信	そうしん	信号を送ること。特に、電気信号を遠方に送ること。「緊急信号を―する」「メールを―する」⇔受信。	transmission (of a message)
創造	そうぞう		creation
想像	そうぞう		imagination, guess
騒々しい	そうぞうしい		noisy, boisterous
相続	そうぞく		succession, inheritance
壮大	そうだい		magnificent, grand, majestic, splendid
相談	そうだん		consultation, discussion
装置	そうち		equipment, installation, apparatus
漕艇	そうてい		rowing boat
相当	そうとう		suitable, fair, tolerable, proper, extremely
騒動	そうどう		strife, riot, rebellion
遭難	そうなん		disaster, shipwreck, accident
挿入	そうにゅう	中にさし入れること。中にはさみこむこと。「イラストを―する」	(an) insertion (into)
相場	そうば		market price, speculation, estimation
装備	そうび	必要な機器などを取り付けること。戦闘・登山など特定の目的に応じた用具をそろえたり身につけたりすること。また、その機器や用具。「魚探機をーする」「冬山用のー」	equipment
送別	そうべつ		farewell, send-off
総理大臣	そうりだいじん		Prime Minister
創立	そうりつ		establishment, founding, organization
送料	そうりょう		postage
添える1	そえる	主となるもののそばにつける。補助として付け加える。「贈り物に手紙を―・える」「薬味を―・える」「介護の手を―・える」	〔そばに付けておく〕attach (to)
添える2	そえる	付き添わせる。付き従わせる。「旅行に案内役を―・える」	〔付け加える〕add (to)
疎遠	そえん	遠ざかって関係が薄いこと。音信や訪問が久しく途絶えていること。また、そのさま。「平素の―をわびる」「―になる」「―な間柄」	alienate, estrange; drift (apart)
即座に	そくざに		immediately, right away
即死	そくし	事故などにあったその時点ですぐさま死ぬこと。「―状態」	instant death
促進	そくしん		promotion, acceleration, encouragement, facilitation, spurring on
即時	そくじ	すぐその時。即刻。また、短時間。副詞的にも用いる。「ーの判断が要求される」「ー徹退せよ」「ー通話」	instantly; promptly; at once; 〔その場で〕on the spot
側室	そくしつ	貴人のめかけ。そばめ。⇔正室／嫡室。	a nobleman's concubine [mistress]
即する	そくする		to conform to, to agree with, to be adapted to, to be based on
速達	そくたつ		express, special delivery
測定	そくてい		measurement
速度	そくど		speed, velocity, rate
束縛	そくばく		restraint, shackles, restriction, confinement, binding
側面	そくめん		side, flank, sidelight, lateral
測量	そくりょう		measurement, surveying
速力	そくりょく		speed
狙撃	そげき	狙い撃ち	sniping
其処	そこ		that place, there
底	そこ		bottom, sole
其処で1	そこで	前述の事柄を受けて、次の事柄を導く。それで。そんなわけで。「いろいろ意見された。ー考えた」	So then; that was why
其処で2	そこで	話題をかえたり、話題をもとにもどしたりすることを示す。さて。	now; ..; Okay; ..
損なう	そこなう		to harm, to hurt, to injure, to damage, to fail in doing
其処ら	そこら		everywhere, somewhere, approximately, that area, around there
素材	そざい	もとになる材料。原料。材料	material
阻止	そし	妨げること。くいとめること。はばむこと。「反対派の入場を―する」	obstruction, check, hindrance, prevention, interdiction
組織	そしき		organization, structure, construction, tissue, system
素質	そしつ		character, qualities, genius
然して	そして		and
訴訟	そしょう		litigation, lawsuit
租税	そぜい	国または地方公共団体が、その経費に充てるために、法律に基づいて国民や住民から強制的に徴収する金銭。国税と地方税とがある。税。税金。	taxes⇒ぜいきん(税金)
祖先	そせん		ancestor
注ぐ1	そそぐ		pour (into), fill, irrigate, pay, feed (a fire)
育ち	そだち		breeding, growth
育つ	そだつ		bring up, be brought up, grow (up)
育てる	そだてる		bring up
措置	そち	事態に応じて必要な手続きをとること。取り計らって始末をつけること。処置。「万全のーをとる」「適当にーする」	a measure (against); a step
其方	そちら		over there, the other
卒業	そつぎょう		graduate
卒論	そつろん	大学の学部の学生が卒業に際して提出し、審査を受ける論文。	a graduation thesis
卒業論文	そつぎょうろんぶん	大学の学部の学生が卒業に際して提出し、審査を受ける論文。	a graduation thesis
素っ気ない	そっけない		cold, short, curt, blunt
率直	そっちょく		frankness, candour, openheartedness
卒直	そっちょく		frankness, candour, openheartedness
外方	そっぽ		look (or turn) the other way
袖	そで		sleeve
外1	そと		other place, the rest
備え付ける	そなえつける		to provide, to furnish, to equip, to install
具える	そなえる		furnish, provide for, equip, install, have ready, prepare for, possess, have, be endowed with, be armed with
備える	そなえる	ある事態が起こったときにうろたえないように、また、これから先に起こる事態に対応できるように準備しておく。心構えをしておく。「万一に―・える」「地震に―・える」「試験に―・えて夜遅くまで勉強する」	to furnish, to provide for, to equip, to install, to have ready, to prepare for, to possess, to have, to be endowed with, to be armed with
備わる	そなわる		to be furnished with, to be endowed with, to possess, to be among, to be one of, to be possessed of
園2	その		garden, park, plantation
その上	そのうえ		in addition, furthermore
其の後	そのご	ある事があったあと。それ以来。以後。副詞的にも用いる。「事件の―は知らない」「―いかがお過ごしですか」	after that
その後	そのご	ある事があったあと。それ以来。以後。副詞的にも用いる。「事件の―は知らない」「―いかがお過ごしですか」	after that
其の度	そのたび	ある事が行われたり、ある状況になったりすると、決まって生じるさま。その時々・その時その時・決まって・いつも	whenever; each time
そのたび	其の度	ある事が行われたり、ある状況になったりすると、決まって生じるさま。その時々・その時その時・決まって・いつも	whenever; each time
その為	そのため		hence, for that reason
その外	そのほか		besides, in addition, the rest
側3	そば		near, close, beside, vicinity, proximity, besides, while
蕎麦	そば	穀物のソバの実を原料とする蕎麦粉を用いて加工した、日本の麺類の一種、および、それを用いた料理である。	soba (buckwheat noodles)
祖父	そふ		grand father
祖母	そぼ		grand mother
素朴	そぼく		simplicity, artlessness, naivete
粗末	そまつ		crude, rough, plain, humble
染まる	そまる		to dye
背く	そむく		to run counter to, to go against, to disobey, to infringe
染める	そめる		to dye, to colour
抑	そもそも	最初。発端。副詞的にも用いる。元々。大体「この話には―から反対だった」「目的が―違う」	in the first place; from the beginning
空2	そら	頭上はるかに高く広がる空間。天。天空。「鳥のようにーを飛び回りたい」	sky
空3	そら	その人の居住地や本拠地から遠く離れている場所。または、境遇。「異国のー」「旅のー」	land; place; location;
空4	そら	心の状態。心持ち。心地。また、心の余裕。「生きたーもない」	feelings; emotion
空5	そら	それらしく思われるが実際はそうでない、という意を表す。うそ。いつわり。「ー涙」「ー笑い」「ーとぼける」	pretending; lie
空6	そら	すっかり覚え込んでいて、書いたものなどを見ないで済むこと。「山手線の駅名をーで言える」	(learn) by heart; (recite) from memory
逸らす	そらす		to turn away, to avert
反り	そり		warp, curvature, curve, arch
剃る	そる	毛髪やひげなどを、かみそりなどで根元からきれいに切り落とす。「ひげを―・る」	shave (hair)
其れ	それ		〔相手に近い物〕that; it
各々1	それぞれ		each, every, either, respectively, severally
それでは		前に示された事柄を受けて、それに対する判断・意見などを導く。そういうことなら。それなら。では。それじゃ。「ーいずれ手にはいるね」「ーこうしたらどうか」	Well then; all right; So..; now..;
それじゃ		前に示された事柄を受けて、それに対する判断・意見などを導く。そういうことなら。それなら。では。それでは。「ーいずれ手にはいるね」「ーこうしたらどうか」	Well then; all right; So..; now..;
其れ程	それほど		to that degree, extent
其れ故	それゆえ		therefore, for that reason, so
逸れる	それる		stray from subject, get lost, go astray
揃える	そろえる	二つ以上のものの、形・大きさなどを同じにする。「ひもの長さをー・える」「彼とセーターの柄を＿・える」	carries; gathers
徐々	そろそろ	動作が静かにゆっくりと行われるさま。そろり。ぼつぼつ「ー歩く」	gradually, steadily, quietly, slowly, soon
算盤	そろばん		abacus
損	そん		loss, disadvantage
損害	そんがい		damage, injury, loss
尊敬	そんけい		respect, esteem, reverence, honour
存在	そんざい		existence, being
損失	そんしつ		loss
存続	そんぞく		duration, continuance
尊重	そんちょう		respect, esteem, regard
損得	そんとく		loss and gain, advantage and disadvantage
そんな		聞き手、または、そのそばにいる人が当面している事態や、現に置かれている状況がそのようであるさま。それほどの。そのような。「―話は聞いたことがない」「―に嫌ならやめなさい」	(all) that; such (a fuss); very  (much)
